name,taxonomy_id,taxonomy_lvl,kraken_assigned_reads,added_reads,new_est_reads,fraction_total_reads
Limnohabitans sp. 63ED37-2,1678128,S,117841,27800,145641,0.08409
Limnohabitans sp. TEGF004,2986281,S,86941,21688,108629,0.06272
Limnohabitans sp. INBF002,2986280,S,38073,11334,49407,0.02853
Limnohabitans sp. MORI2,1751150,S,26666,4928,31594,0.01824
Limnohabitans sp. 103DPR2,1678129,S,22510,3549,26059,0.01505
Pseudomonas putida,303,S,3349,16233,19582,0.01131
Paracidovorax avenae,80867,S,1708,16893,18601,0.01074
Variovorax paradoxus,34073,S,8190,8211,16401,0.00947
Acidovorax sp. T1,1858609,S,2013,13103,15116,0.00873
Comamonas testosteroni,285,S,3175,11894,15069,0.0087
Hydrogenophaga sp. PBL-H3,434010,S,4632,9388,14020,0.00809
Acidovorax temperans,80878,S,3317,10203,13520,0.00781
Acidovorax carolinensis,553814,S,4087,8807,12894,0.00744
Pseudomonas sp. StFLB209,1028989,S,8385,2514,10899,0.00629
Pseudomonas aeruginosa,287,S,760,9902,10662,0.00616
Alicycliphilus denitrificans,179636,S,2237,8085,10322,0.00596
Hydrogenophaga pseudoflava,47421,S,2076,7602,9678,0.00559
Polaromonas sp. JS666,296591,S,5132,4510,9642,0.00557
Flavobacterium ammoniigenes,1751095,S,6586,2954,9540,0.00551
Hydrogenophaga sp. BPS33,2651974,S,3896,5392,9288,0.00536
Rhodoluna sp. KAS3,942880,S,5621,3502,9123,0.00527
Hydrogenophaga sp. NH-16,2184519,S,1616,7491,9107,0.00526
Delftia tsuruhatensis,180282,S,1315,7768,9083,0.00524
Ramlibacter tataouinensis,94132,S,6076,2990,9066,0.00523
Acidovorax sp. JMULE5,2518343,S,5930,2937,8867,0.00512
Comamonas aquatica,225991,S,3465,5338,8803,0.00508
Pseudomonas chlororaphis,587753,S,1943,6690,8633,0.00498
Hydrogenophaga sp. SL48,2806347,S,6104,2445,8549,0.00494
Pseudomonas syringae,317,S,2335,6019,8354,0.00482
Hydrogenophaga taeniospiralis,65656,S,5355,2785,8140,0.0047
Acidovorax sp. KKS102,358220,S,3676,4430,8106,0.00468
Rhodoferax sp. BAB1,2741720,S,4952,2732,7684,0.00444
Aquirufa antheringensis,2516559,S,6024,1630,7654,0.00442
Flavobacterium commune,1306519,S,5436,1937,7373,0.00426
Hydrogenophaga sp. RAC07,1842537,S,4534,2445,6979,0.00403
Polynucleobacter yangtzensis,1743159,S,5130,1809,6939,0.00401
Pseudomonas fluorescens,294,S,2743,4201,6944,0.00401
Rhodoferax sp. TBRC 17307,3068341,S,2613,4283,6896,0.00398
Rhodoferax koreense,1842727,S,2932,3864,6796,0.00392
Hydrogenophaga crocea,2716225,S,3069,3520,6589,0.0038
Rhodoferax saidenbachensis,1484693,S,5322,1209,6531,0.00377
Acidovorax sp. RAC01,1842533,S,3081,3406,6487,0.00375
Curvibacter sp. AEP1-3,1844971,S,2942,3405,6347,0.00366
Hydrogenophaga sp. PBC,795665,S,2512,3356,5868,0.00339
Aurantimicrobium photophilum,1987356,S,4812,1037,5849,0.00338
Rhodoferax sp. AJA081-3,2752316,S,4977,773,5750,0.00332
Acidovorax sp. 1608163,2478662,S,4006,1724,5730,0.00331
Leptothrix cholodnii,34029,S,3700,2021,5721,0.0033
Polynucleobacter sp. AP-Ainpum-60-G11,2576926,S,4429,1203,5632,0.00325
Rhodoluna lacicola,529884,S,4690,604,5294,0.00306
Pseudomonas fulva,47880,S,1390,3827,5217,0.00301
Acinetobacter sp. TTH0-4,1646498,S,3564,1555,5119,0.00296
Flavobacterium limnophilum,3003262,S,3959,1166,5125,0.00296
Pseudomonas protegens,380021,S,1183,3885,5068,0.00293
Polynucleobacter sp. MWH-CaK5,2689107,S,4593,253,4846,0.0028
Candidatus Planktophila sulfonica,1884904,S,3698,1007,4705,0.00272
uncultured Hydrogenophaga sp.,199683,S,3117,1583,4700,0.00271
Acinetobacter johnsonii,40214,S,1898,2769,4667,0.00269
Diaphorobacter sp. JS3051,2792224,S,163,4383,4546,0.00262
Hydrogenophaga sp. YM1,2806262,S,2419,2058,4477,0.00258
Delftia acidovorans,80866,S,1093,3310,4403,0.00254
Escherichia coli,562,S,211,4129,4340,0.00251
Phnomibacter ginsenosidimutans,2676868,S,3920,427,4347,0.00251
Acinetobacter baumannii,470,S,315,3979,4294,0.00248
Polaromonas naphthalenivorans,216465,S,3324,795,4119,0.00238
Klebsiella pneumoniae,573,S,101,3965,4066,0.00235
Flavobacterium ammonificans,1751056,S,2826,1224,4050,0.00234
Hydrogenophaga sp. PAMC20947,2565558,S,3621,391,4012,0.00232
Rhodoferax sp. MIZ03,2798804,S,3365,653,4018,0.00232
Hydrogenophaga crassostreae,1763535,S,3540,350,3890,0.00225
Comamonas thiooxydans,363952,S,1231,2672,3903,0.00225
Sphaerotilus sp. FB-5,2914710,S,1950,1940,3890,0.00225
Acidovorax radicis,758826,S,2758,1120,3878,0.00224
Acidovorax sp. HDW3,2714923,S,1946,1919,3865,0.00223
Rhodoferax sediminis,2509614,S,2970,846,3816,0.0022
Pseudomonas sp. S34,1573718,S,1972,1792,3764,0.00217
Enterobacter kobei,208224,S,314,3416,3730,0.00215
Rhodoluna limnophila,232537,S,2608,1097,3705,0.00214
Bradyrhizobium diazoefficiens,1355477,S,1150,2512,3662,0.00211
Rhodoferax ferrireducens,192843,S,3234,403,3637,0.0021
Rhodoferax aquaticus,2527691,S,2955,687,3642,0.0021
[Acidovorax] ebreus,721785,S,358,3234,3592,0.00207
Sphaerotilus sulfidivorans,639200,S,2187,1397,3584,0.00207
Lacibacter sp. S13-6-22,2760713,S,3427,120,3547,0.00205
Simplicispira suum,2109915,S,2067,1451,3518,0.00203
Rhodoferax sp. PAMC 29310,2822760,S,2901,588,3489,0.00201
Paenacidovorax monticola,1926868,S,1763,1687,3450,0.00199
Variovorax sp. PBL-H6,434009,S,928,2462,3390,0.00196
Diaphorobacter sp. HDW4A,2714924,S,1342,2042,3384,0.00195
Ottowia oryzae,2109914,S,2426,920,3346,0.00193
Aquincola tertiaricarbonis,391953,S,1992,1349,3341,0.00193
Comamonas antarctica,2743470,S,1470,1815,3285,0.0019
Bradyrhizobium barranii,2992140,S,747,2458,3205,0.00185
Ideonella dechloratans,36863,S,1277,1835,3112,0.0018
Bradyrhizobium japonicum,375,S,1017,2102,3119,0.0018
Comamonas sp. ZM22,3046670,S,1170,1933,3103,0.00179
Acinetobacter sp. CS-2,2798861,S,1550,1556,3106,0.00179
Comamonas fluminis,2796366,S,1772,1285,3057,0.00177
Flavobacterium eburneipallidum,3003263,S,2374,651,3025,0.00175
Rhodoferax antarcticus,81479,S,2605,333,2938,0.0017
Diaphorobacter aerolatus,1288495,S,926,1994,2920,0.00169
Rhizobacter sp. AJA081-3,2753607,S,2013,895,2908,0.00168
Comamonas terrigena,32013,S,2075,786,2861,0.00165
Stenotrophomonas maltophilia,40324,S,787,2071,2858,0.00165
Aquirufa lenticrescens,2696560,S,2260,595,2855,0.00165
Hylemonella gracilis,80880,S,2278,540,2818,0.00163
Comamonas kerstersii,225992,S,1874,924,2798,0.00162
Variovorax sp. WDL1,207745,S,808,1974,2782,0.00161
Pseudomonas amygdali,47877,S,221,2572,2793,0.00161
Polynucleobacter sp. KF022,2982615,S,2051,682,2733,0.00158
Flavobacterium nackdongense,2547394,S,2328,394,2722,0.00157
Pseudomonas cichorii,36746,S,675,2019,2694,0.00156
Pseudomonas viridiflava,33069,S,2286,380,2666,0.00154
Candidatus Planktophila lacus,1884913,S,2380,270,2650,0.00153
Comamonas serinivorans,1082851,S,1851,789,2640,0.00152
Caulobacter segnis,88688,S,1723,906,2629,0.00152
Ottowia testudinis,2816950,S,1968,635,2603,0.0015
Pulveribacter suum,2116657,S,1334,1242,2576,0.00149
Diaphorobacter sp. ED-3,3016636,S,128,2440,2568,0.00148
Mycolicibacterium neoaurum,1795,S,1820,728,2548,0.00147
Variovorax sp. PBL-E5,434014,S,431,2094,2525,0.00146
Acidovorax sp. GBBC 1281,2940492,S,1160,1315,2475,0.00143
Serpentinimonas raichei,1458425,S,1767,712,2479,0.00143
Comamonas odontotermitis,379895,S,1855,584,2439,0.00141
Variovorax boronicumulans,436515,S,954,1485,2439,0.00141
Melaminivora suipulveris,2109913,S,1011,1389,2400,0.00139
Polynucleobacter sp. MWH-Aus1W21,1855880,S,1768,625,2393,0.00138
Cupriavidus taiwanensis,164546,S,982,1405,2387,0.00138
Burkholderia pseudomallei,28450,S,172,2209,2381,0.00137
Melaminivora jejuensis,1267217,S,1159,1181,2340,0.00135
Verminephrobacter eiseniae,364317,S,1938,377,2315,0.00134
Rhizobium leguminosarum,384,S,534,1756,2290,0.00132
Kinneretia sp. DAIF2,2714952,S,1346,929,2275,0.00131
Delftia lacustris,558537,S,193,2036,2229,0.00129
Comamonas sp. Y33R10-2,2853257,S,1739,456,2195,0.00127
Acidovorax sp. NCPPB 3576,2940488,S,1085,1089,2174,0.00126
Variovorax sp. PBS-H4,434008,S,951,1213,2164,0.00125
Variovorax sp. RA8,662548,S,878,1275,2153,0.00124
Pseudomonas brassicacearum,930166,S,294,1860,2154,0.00124
Gemmobacter aquarius,2169400,S,1306,843,2149,0.00124
Serpentinimonas maccroryi,1458426,S,1417,690,2107,0.00122
Rubrivivax gelatinosus,28068,S,1349,766,2115,0.00122
Paucibacter sp. KCTC 42545,1768242,S,1619,476,2095,0.00121
Lacunisphaera limnophila,1838286,S,1711,359,2070,0.0012
Diaphorobacter sp. HDW4B,2714925,S,1731,328,2059,0.00119
Paucibacter sp. S2-9,3019553,S,1292,774,2066,0.00119
Caldimonas thermodepolymerans,215580,S,978,1051,2029,0.00117
Bacillus cereus,1396,S,103,1927,2030,0.00117
Novosphingobium aromaticivorans,48935,S,637,1333,1970,0.00114
Micromonospora sp. HM134,2583243,S,724,1246,1970,0.00114
Variovorax sp. HW608,1034889,S,1512,432,1944,0.00112
Variovorax sp. 38R,2774875,S,635,1294,1929,0.00111
Flavobacterium nitratireducens,992289,S,1366,533,1899,0.0011
Achromobacter spanius,217203,S,624,1261,1885,0.00109
Shinella sp. XGS7,2877941,S,850,1043,1893,0.00109
Mucilaginibacter rubeus,2027860,S,235,1623,1858,0.00107
Comamonas flocculans,2597701,S,868,962,1830,0.00106
Variovorax sp. PAMC26660,2762322,S,1222,598,1820,0.00105
Xylophilus rhododendri,2697032,S,1173,638,1811,0.00105
Ferribacterium limneticum,76259,S,1473,350,1823,0.00105
Neisseria gonorrhoeae,485,S,951,859,1810,0.00105
Pseudomonas frederiksbergensis,104087,S,812,982,1794,0.00104
Xanthomonas campestris,339,S,267,1539,1806,0.00104
Methylobacterium oryzae,334852,S,567,1231,1798,0.00104
Anabaena sp. 90,46234,S,568,1219,1787,0.00103
Achromobacter xylosoxidans,85698,S,588,1156,1744,0.00101
Acidovorax sp. 5MLIR,2949090,S,982,747,1729,0.001
Comamonas piscis,1562974,S,1384,345,1729,0.001
Variovorax sp. PAMC 28711,1795631,S,1331,393,1724,0.001
Stutzerimonas stutzeri,316,S,646,1084,1730,0.001
Aquabacterium sp. J223,2898431,S,1080,634,1714,0.00099
Curtobacterium sp. MR_MD2014,1561023,S,668,1048,1716,0.00099
Rhizobacter gummiphilus,946333,S,1250,447,1697,0.00098
Candidatus Planktophila dulcis,1884914,S,1320,364,1684,0.00097
Variovorax sp. RKNM96,2681552,S,938,719,1657,0.00096
Paucibacter aquatile,2070761,S,1248,418,1666,0.00096
Tepidimonas taiwanensis,307486,S,1016,655,1671,0.00096
Flavobacterium sp. IMCC34518,3003623,S,132,1511,1643,0.00095
Opitutus sp. GAS368,1882749,S,1429,225,1654,0.00095
Aquirufa nivalisilvae,2516557,S,1471,150,1621,0.00094
Alcaligenes faecalis,511,S,539,1057,1596,0.00092
Priestia megaterium,1404,S,390,1183,1573,0.00091
Piscinibacter sp. XHJ-5,3037797,S,1246,291,1537,0.00089
Comamonas sp. B21-038,2918299,S,1096,422,1518,0.00088
Variovorax sp. PAMC28562,2762323,S,1359,162,1521,0.00088
Anabaena sp. WA102,1647413,S,676,851,1527,0.00088
Variovorax sp. SRS16,282217,S,301,1200,1501,0.00087
Paracidovorax citrulli,80869,S,474,1029,1503,0.00087
Aquabacterium olei,1296669,S,1039,474,1513,0.00087
Vitreoscilla filiformis,63,S,1133,378,1511,0.00087
Cupriavidus basilensis,68895,S,655,811,1466,0.00085
Brevundimonas vesicularis,41276,S,319,1135,1454,0.00084
Dolichospermum flos-aquae,1166,S,432,1018,1450,0.00084
Polynucleobacter necessarius,576610,S,1250,187,1437,0.00083
Sphingobium yanoikuyae,13690,S,274,1159,1433,0.00083
Bradyrhizobium elkanii,29448,S,271,1152,1423,0.00082
Flavobacterium praedii,3002900,S,111,1306,1417,0.00082
Diaphorobacter ruginosibacter,1715720,S,1051,348,1399,0.00081
Novosphingobium sp. EMRT-2,2571749,S,582,797,1379,8e-04
Polaromonas vacuolata,37448,S,1127,235,1362,0.00079
Ottowia sp. oral taxon 894,1658672,S,1088,258,1346,0.00078
Cupriavidus pauculus,82633,S,731,612,1343,0.00078
Micromonospora sp. HUAS LYJ1,3061626,S,540,814,1354,0.00078
Acinetobacter sp. WCHAc010034,1879049,S,752,582,1334,0.00077
Agrobacterium tumefaciens,358,S,605,721,1326,0.00077
Emticicia oligotrophica,312279,S,1251,77,1328,0.00077
Comamonas sp. PR12,2977320,S,183,1137,1320,0.00076
Candidatus Rhodoluna planktonica,535712,S,1174,138,1312,0.00076
Candidatus Planktophila limnetica,573600,S,1223,93,1316,0.00076
Candidatus Planktophila vernalis,1884907,S,1206,110,1316,0.00076
Fuscovulum sp. YMD61,3042299,S,1013,292,1305,0.00075
Dolichospermum sp. UHCC 0315A,1914871,S,440,853,1293,0.00075
Cupriavidus necator,106590,S,616,664,1280,0.00074
Microbacterium sp. SSW1-36,2851648,S,603,678,1281,0.00074
Inhella inkyongensis,392593,S,994,267,1261,0.00073
Flavobacterium johnsoniae,986,S,290,980,1270,0.00073
Aeromonas veronii,654,S,356,899,1255,0.00072
Mesorhizobium opportunistum,593909,S,118,1132,1250,0.00072
Microbacterium testaceum,2033,S,674,580,1254,0.00072
Streptomyces venezuelae,54571,S,346,893,1239,0.00072
Dolichospermum compactum,136073,S,892,350,1242,0.00072
Comamonas sp. NLF-1-9,2853163,S,792,430,1222,0.00071
Comamonas koreensis,160825,S,181,1056,1237,0.00071
Pseudomonas fragi,296,S,550,676,1226,0.00071
Candidatus Nanopelagicus limnes,1884634,S,969,262,1231,0.00071
Paracidovorax cattleyae,80868,S,434,771,1205,7e-04
Acinetobacter sp. ACNIH2,1758189,S,115,1097,1212,7e-04
Candidatus Planktophila versatilis,1884905,S,1035,161,1196,0.00069
Methylibium sp. Pch-M,2082386,S,516,655,1171,0.00068
Pseudomonas azotoformans,47878,S,265,907,1172,0.00068
Halomonas sp. JS92-SW72,2306583,S,180,1000,1180,0.00068
Caldimonas brevitalea,413882,S,909,248,1157,0.00067
Eleftheria terrae,1597781,S,875,284,1159,0.00067
Microbacterium foliorum,104336,S,242,926,1168,0.00067
Mycolicibacterium aurum,1791,S,904,262,1166,0.00067
Mycobacterium sp. ITM-2016-00316,2099695,S,458,706,1164,0.00067
Flavobacterium sp. 20NA77.7,3073563,S,894,268,1162,0.00067
Pseudomonas baltica,2762576,S,1011,124,1135,0.00066
Rhodopseudomonas palustris,1076,S,588,558,1146,0.00066
Mycolicibacterium frederiksbergense,117567,S,432,707,1139,0.00066
Streptomyces sp. AMCC400023,2056258,S,109,1032,1141,0.00066
Burkholderia gladioli,28095,S,735,391,1126,0.00065
Pseudomonas lijiangensis,2995658,S,836,275,1111,0.00064
Serratia marcescens,615,S,173,934,1107,0.00064
Methylibium petroleiphilum,105560,S,494,590,1084,0.00063
Aeromonas hydrophila,644,S,260,828,1088,0.00063
Paracoccus yeei,147645,S,139,947,1086,0.00063
Arthrobacter sp. NEB 688,904039,S,100,993,1093,0.00063
Flavobacterium lacustre,3016339,S,804,281,1085,0.00063
Schlegelella aquatica,376175,S,675,391,1066,0.00062
Aquiluna sp. KACHI24,2968831,S,834,241,1075,0.00062
Aurantimicrobium minutum,708131,S,517,560,1077,0.00062
Micromonospora sp. WMMD714,3016097,S,160,913,1073,0.00062
Novosphingobium resinovorum,158500,S,492,561,1053,0.00061
Curtobacterium flaccumfaciens,2035,S,176,887,1063,0.00061
Peribacillus simplex,1478,S,416,641,1057,0.00061
Dolichospermum heterosporum,747522,S,567,487,1054,0.00061
Roseateles depolymerans,76731,S,707,331,1038,6e-04
Dechloromonas denitrificans,281362,S,783,259,1042,6e-04
Candidatus Fonsibacter ubiquis,1925548,S,985,52,1037,6e-04
Mycolicibacterium sediminis,1286180,S,726,321,1047,6e-04
Streptomyces caniscabiei,2746961,S,103,939,1042,6e-04
Pseudomonas coleopterorum,1605838,S,774,240,1014,0.00059
Roseateles sp. BIM B-1768,2978473,S,756,257,1013,0.00058
Novosphingobium sp. THN1,1016987,S,636,371,1007,0.00058
Gemmobacter fulvus,2840474,S,592,419,1011,0.00058
Mycolicibacterium nivoides,2487344,S,366,633,999,0.00058
Rhodococcus opacus,37919,S,126,874,1000,0.00058
Flavobacterium sp. Sr18,935222,S,470,541,1011,0.00058
Mitsuaria sp. 7,1658665,S,712,278,990,0.00057
Pseudomonas sp. UW4,1207075,S,245,742,987,0.00057
Lysobacter enzymogenes,69,S,311,678,989,0.00057
Mycobacterium adipatum,1682113,S,395,597,992,0.00057
Flavobacterium sp. ZE23DGlu08,3059026,S,633,351,984,0.00057
Ralstonia solanacearum,305,S,441,537,978,0.00056
Roseateles sp. SL47,2995138,S,708,265,973,0.00056
Devosia sp. A16,1736675,S,800,165,965,0.00056
Janthinobacterium agaricidamnosum,55508,S,321,631,952,0.00055
Thauera sp. MZ1T,85643,S,400,552,952,0.00055
Streptomyces sp. HUAS CB01,3053466,S,335,614,949,0.00055
Flavobacterium aquiphilum,3003261,S,730,223,953,0.00055
Pseudomonas alcaligenes,43263,S,484,452,936,0.00054
Acinetobacter indicus,756892,S,488,451,939,0.00054
Nocardioides sp. S5,2017486,S,408,534,942,0.00054
Burkholderia cenocepacia,95486,S,114,806,920,0.00053
Pseudomonas synxantha,47883,S,356,568,924,0.00053
Pseudomonas psychrotolerans,237610,S,568,355,923,0.00053
Novosphingobium sp. ES2-1,2780074,S,458,454,912,0.00053
Streptomyces sp. VNUA24,3031131,S,117,796,913,0.00053
Sphingopyxis granuli,267128,S,154,754,908,0.00052
Rhizorhabdus dicambivorans,1850238,S,253,648,901,0.00052
Caulobacter flavus,1679497,S,607,290,897,0.00052
Mycolicibacterium fluoranthenivorans,258505,S,704,203,907,0.00052
Bordetella bronchiseptica,518,S,110,774,884,0.00051
Acinetobacter towneri,202956,S,194,692,886,0.00051
Phenylobacterium zucineum,284016,S,570,313,883,0.00051
Mycobacterium gallinarum,39689,S,447,433,880,0.00051
Diaphorobacter sp. C33,3060154,S,119,753,872,5e-04
Shinella zoogloeoides,352475,S,228,640,868,5e-04
Pseudomonas mendocina,300,S,437,413,850,0.00049
Pseudomonas phytophila,2867264,S,756,90,846,0.00049
Pseudomonas lurida,244566,S,511,333,844,0.00049
Acinetobacter lwoffii,28090,S,214,636,850,0.00049
Sphingomonas sp. MM-1,745310,S,190,661,851,0.00049
Sphingomonas hankookensis,563996,S,273,579,852,0.00049
Ralstonia mannitolilytica,105219,S,378,460,838,0.00048
Mesorhizobium sp. 8,2584466,S,114,724,838,0.00048
Streptomyces sp. P3,2135430,S,257,573,830,0.00048
Streptomyces sp. 3214.6,1882757,S,227,603,830,0.00048
Streptomyces noursei,1971,S,127,697,824,0.00048
Pseudomonas siliginis,2842346,S,121,693,814,0.00047
Cupriavidus metallidurans,119219,S,392,413,805,0.00046
Herbaspirillum frisingense,92645,S,541,248,789,0.00046
Pseudomonas alkylphenolica,237609,S,588,215,803,0.00046
Pseudomonas laurylsulfatiphila,2011015,S,404,401,805,0.00046
Rhizorhabdus wittichii,160791,S,327,469,796,0.00046
Streptomyces sp. HUAS 15-9,2981136,S,259,533,792,0.00046
Polynucleobacter sp. HIN8,3047867,S,364,409,773,0.00045
Pseudomonas orientalis,76758,S,487,287,774,0.00045
Pseudoxanthomonas mexicana,128785,S,299,474,773,0.00045
Caulobacter vibrioides,155892,S,461,320,781,0.00045
Aquiluna borgnonia,2499157,S,640,147,787,0.00045
Nibricoccus aquaticus,2576891,S,725,63,788,0.00045
Pseudomonas sp. PIA16,2931382,S,619,139,758,0.00044
Pseudomonas sp. FP1742,2954079,S,156,598,754,0.00044
Pseudomonas savastanoi,29438,S,102,665,767,0.00044
Xanthomonas translucens,343,S,242,521,763,0.00044
Tabrizicola piscis,2494374,S,570,184,754,0.00044
Brevundimonas sp. GW460-12-10-14-LB2,1827469,S,138,621,759,0.00044
Caulobacter rhizosphaerae,2010972,S,522,236,758,0.00044
Ferrovibrio terrae,2594003,S,654,103,757,0.00044
Streptomyces chartreusis,1969,S,112,650,762,0.00044
Flavobacterium sp. IMCC34852,2732161,S,574,189,763,0.00044
Flavobacterium sp. F-29,2893883,S,548,218,766,0.00044
Ralstonia pseudosolanacearum,1310165,S,154,587,741,0.00043
Massilia violaceinigra,2045208,S,514,224,738,0.00043
Pseudomonas sp. URMO17WK12:I11,1283291,S,166,575,741,0.00043
Pseudomonas citronellolis,53408,S,176,561,737,0.00043
Acinetobacter tibetensis,2943497,S,621,116,737,0.00043
Pseudosulfitobacter pseudonitzschiae,1402135,S,160,588,748,0.00043
Caulobacter sp. S6,2823693,S,270,468,738,0.00043
Flavobacterium marginilacus,3003256,S,584,169,753,0.00043
Luteolibacter sp. SL250,2995170,S,655,87,742,0.00043
Synechococcus phage S-SRM01,2781608,S,459,289,748,0.00043
Polynucleobacter asymbioticus,576611,S,620,106,726,0.00042
Cupriavidus campinensis,151783,S,426,301,727,0.00042
Achromobacter sp. AONIH1,1758194,S,259,473,732,0.00042
Dechloromonas sp. A34,447588,S,594,131,725,0.00042
Pseudomonas sp. WJP1,2986947,S,422,311,733,0.00042
Pseudomonas oryzihabitans,47885,S,387,344,731,0.00042
Shewanella xiamenensis,332186,S,101,634,735,0.00042
Sphingomonas panacis,1560345,S,603,120,723,0.00042
Novosphingobium ginsenosidimutans,1176536,S,627,105,732,0.00042
Croceicoccus naphthovorans,1348774,S,153,581,734,0.00042
Brevundimonas sp. M20,2591463,S,554,175,729,0.00042
Caulobacter sp. NIBR1757,3016000,S,558,163,721,0.00042
Marmoricola scoriae,642780,S,370,351,721,0.00042
Flavobacterium sp. N3904,2986835,S,537,188,725,0.00042
Diaphorobacter nitroreducens,164759,S,132,584,716,0.00041
Pseudomonas poae,200451,S,254,453,707,0.00041
Curtobacterium sp. BH-2-1-1,1905847,S,335,374,709,0.00041
Mycolicibacterium septicum,98668,S,246,461,707,0.00041
Pimelobacter simplex,2045,S,215,495,710,0.00041
Flavobacterium gilvum,1492737,S,550,156,706,0.00041
Bordetella petrii,94624,S,232,467,699,4e-04
Ensifer adhaerens,106592,S,446,242,688,4e-04
Sphingomonas melonis,152682,S,106,585,691,4e-04
Rhodococcus fascians,1828,S,483,209,692,4e-04
Flavobacterium channae,2897181,S,383,313,696,4e-04
Massilia sp. WG5,1707785,S,374,306,680,0.00039
Herbaspirillum huttiense,863372,S,429,255,684,0.00039
Pseudomonas azerbaijanorientalis,2842350,S,196,471,667,0.00039
Pantoea agglomerans,549,S,326,347,673,0.00039
Bradyrhizobium sp. 170,2782641,S,304,377,681,0.00039
Streptomyces sp. GQFP,2907545,S,282,392,674,0.00039
Rugamonas sp. DEMB1,3039386,S,398,261,659,0.00038
Candidatus Methylopumilus turicensis,1581680,S,557,108,665,0.00038
Pseudomonas rhodesiae,76760,S,382,270,652,0.00038
Pseudomonas koreensis,198620,S,146,512,658,0.00038
Pseudomonas otitidis,319939,S,479,175,654,0.00038
Azotobacter chroococcum,353,S,272,392,664,0.00038
Aurantimicrobium sp. INA4,2986279,S,323,339,662,0.00038
Mycolicibacterium sp. TUM20985,3023370,S,490,170,660,0.00038
Micromonospora sp. WMMD712,3016096,S,114,536,650,0.00038
Flavobacterium sp. N2820,2986834,S,483,181,664,0.00038
Flavobacterium sp. M31R6,2739062,S,474,192,666,0.00038
Polynucleobacter sp. MWH-Spelu-300-X4,2689109,S,610,32,642,0.00037
Cupriavidus oxalaticus,96344,S,351,298,649,0.00037
Massilia sp. erpn,2738142,S,164,482,646,0.00037
Laribacter hongkongensis,168471,S,348,292,640,0.00037
Candidatus Methylopumilus rimovensis,2588535,S,578,65,643,0.00037
Acinetobacter pittii,48296,S,178,461,639,0.00037
Methylorubrum extorquens,408,S,272,361,633,0.00037
Sphingorhabdus lacus,392610,S,616,30,646,0.00037
Pseudonocardia sp. AL041005-10,445576,S,264,383,647,0.00037
Sorangium cellulosum,56,S,386,254,640,0.00037
Massilia varians,457921,S,392,226,618,0.00036
Fluviibacter phosphoraccumulans,1751046,S,492,135,627,0.00036
Pseudomonas sp. T1-3-2,2908006,S,414,214,628,0.00036
Pseudomonas asplenii,53407,S,128,502,630,0.00036
Tolumonas auensis,43948,S,440,184,624,0.00036
Bradyrhizobium arachidis,858423,S,200,416,616,0.00036
Sphingobium cloacae,120107,S,127,504,631,0.00036
Fuscovulum blasticum,1075,S,439,182,621,0.00036
Brevundimonas sp. scallop,2562582,S,104,520,624,0.00036
Aurantimicrobium sp. MWH-Uga1,2079575,S,408,213,621,0.00036
Streptomyces collinus,42684,S,114,505,619,0.00036
Cupriavidus gilardii,82541,S,262,340,602,0.00035
Duganella dendranthematis,2728021,S,453,148,601,0.00035
Quatrionicoccus australiensis,138118,S,429,178,607,0.00035
Azospira restricta,404405,S,311,293,604,0.00035
Pseudomonas sp. KU26590,2991051,S,450,160,610,0.00035
Pseudomonas sp. Ost2,2678260,S,425,175,600,0.00035
Pseudomonas atacamensis,2565368,S,129,470,599,0.00035
Sphingomonas sanxanigenens,397260,S,238,365,603,0.00035
Sphingobium amiense,135719,S,127,476,603,0.00035
Microbacterium oxydans,82380,S,116,488,604,0.00035
Mycolicibacterium tokaiense,39695,S,443,159,602,0.00035
Flavobacterium cyclinae,2895947,S,388,222,610,0.00035
Herbaspirillum seropedicae,964,S,384,205,589,0.00034
Thiomonas sp. X19,1050370,S,396,199,595,0.00034
Bordetella genomosp. 13,463040,S,312,284,596,0.00034
Pseudomonas sp. L5B5,2883205,S,386,203,589,0.00034
Pseudomonas sp. Cab53,2678258,S,304,282,586,0.00034
Pseudomonas plecoglossicida,70775,S,184,413,597,0.00034
Acinetobacter wuhouensis,1879050,S,320,269,589,0.00034
Acinetobacter piscicola,2006115,S,311,281,592,0.00034
Acinetobacter variabilis,70346,S,164,427,591,0.00034
Agrobacterium fabacearum,1183401,S,115,470,585,0.00034
Methylobacterium radiodurans,2202828,S,417,171,588,0.00034
Sphingomonas taxi,1549858,S,386,199,585,0.00034
Sphingopyxis macrogoltabida,33050,S,284,306,590,0.00034
Streptomyces sp. AM8-1-1,3075825,S,235,348,583,0.00034
Flavobacterium sp. CECT 9288,2845819,S,195,398,593,0.00034
Polynucleobacter sp. MWH-UH24A,2689110,S,266,306,572,0.00033
Cupriavidus pinatubonensis,248026,S,222,354,576,0.00033
Massilia oculi,945844,S,280,292,572,0.00033
Pseudomonas sp. BSw22131,3002903,S,506,62,568,0.00033
Pseudomonas sp. MM211,2866808,S,486,87,573,0.00033
Pseudomonas syringae group genomosp. 7,251699,S,471,98,569,0.00033
Pseudomonas congelans,200452,S,316,253,569,0.00033
Pseudomonas vanderleydeniana,2745495,S,453,115,568,0.00033
Pseudomonas eucalypticola,2599595,S,410,163,573,0.00033
Pseudomonas entomophila,312306,S,380,186,566,0.00033
Pseudomonas parafulva,157782,S,345,223,568,0.00033
Acinetobacter schindleri,108981,S,277,295,572,0.00033
Pantoea ananatis,553,S,404,166,570,0.00033
Rhizobium sp. TH2,2775403,S,368,202,570,0.00033
Sinorhizobium fredii,380,S,269,309,578,0.00033
Methylobacterium brachiatum,269660,S,334,238,572,0.00033
Devosia oryziradicis,2801335,S,391,179,570,0.00033
Pannonibacter phragmitetus,121719,S,128,441,569,0.00033
Sphingomonas koreensis,93064,S,199,381,580,0.00033
Brevundimonas diminuta,293,S,133,431,564,0.00033
Microbacterium sp. Clip185,3025663,S,270,304,574,0.00033
Mycolicibacterium rhodesiae,36814,S,374,203,577,0.00033
Streptomyces griseus,1911,S,108,456,564,0.00033
Streptomyces coeruleorubidus,116188,S,103,464,567,0.00033
Candidatus Nanopelagicus abundans,1884916,S,488,90,578,0.00033
Nocardioides okcheonensis,2894081,S,253,323,576,0.00033
Flavobacterium sp. F-340,2893886,S,362,209,571,0.00033
Delftia sp. Cs1-4,742013,S,136,418,554,0.00032
Massilia sp. NP310,2861282,S,224,326,550,0.00032
Achromobacter deleyi,1353891,S,295,254,549,0.00032
Pseudomonas sp. 15A4,2804761,S,263,288,551,0.00032
Bradyrhizobium erythrophlei,1437360,S,481,67,548,0.00032
Rhizobium sp. SL42,2806346,S,380,179,559,0.00032
Bosea vaviloviae,1526658,S,399,162,561,0.00032
Enhydrobacter sp.,1894999,S,477,80,557,0.00032
Sphingomonas sp. CV7422,3018036,S,252,310,562,0.00032
Croceicoccus marinus,450378,S,229,323,552,0.00032
Rhodobacter capsulatus,1061,S,380,181,561,0.00032
Frigidibacter mobilis,1335048,S,193,361,554,0.00032
Caulobacter soli,2708539,S,376,184,560,0.00032
Mycolicibacterium helvum,1534349,S,425,125,550,0.00032
Verrucosispora sp. NA02020,2742132,S,316,237,553,0.00032
Flavobacterium sp. K5-23,2746225,S,403,156,559,0.00032
Flavobacterium flavigenum,3003258,S,256,301,557,0.00032
Flavobacterium gyeonganense,1310418,S,243,306,549,0.00032
Ralstonia insidiosa,190721,S,292,252,544,0.00031
Massilia sp. REN29,3068633,S,315,220,535,0.00031
Casimicrobium huifangae,2591109,S,353,189,542,0.00031
Pseudomonas sp. OE 28.3,2745519,S,170,374,544,0.00031
Pseudomonas umsongensis,198618,S,377,164,541,0.00031
Pseudomonas knackmussii,65741,S,243,302,545,0.00031
Aeromonas media,651,S,213,329,542,0.00031
Bradyrhizobium sp. S12-14-2,3056648,S,377,157,534,0.00031
Bradyrhizobium canariense,255045,S,147,385,532,0.00031
Rhodopseudomonas sp. SK50-23,340268,S,398,147,545,0.00031
Devosia sp.,1871048,S,389,150,539,0.00031
Bosea sp. RAC05,1842539,S,342,191,533,0.00031
Sphingobium sp. YG1,2082188,S,201,335,536,0.00031
Neotabrizicola shimadae,2807096,S,364,179,543,0.00031
Phenylobacterium sp. NIBR 498073,3015177,S,364,165,529,0.00031
Agrococcus jejuensis,399736,S,272,259,531,0.00031
Streptomyces sp. HM190,2695266,S,146,399,545,0.00031
Flavobacterium sp. CHNK8,2871165,S,172,362,534,0.00031
Flavobacterium nitrogenifigens,1617283,S,136,408,544,0.00031
Chryseobacterium indologenes,253,S,102,430,532,0.00031
Pedobacter sp. G11,2482728,S,423,116,539,0.00031
Herbaspirillum rubrisubalbicans,80842,S,352,161,513,3e-04
Thiomonas intermedia,926,S,400,127,527,3e-04
Parazoarcus communis,41977,S,358,166,524,3e-04
Pseudomonas sp. KNUC1026,2893890,S,469,59,528,3e-04
Pseudomonas sp. LS1212,2972478,S,407,117,524,3e-04
Pseudomonas sp. PSKL.D1,3029060,S,241,270,511,3e-04
Acinetobacter sp. TGL-Y2,1407071,S,475,42,517,3e-04
Bradyrhizobium sp. 200,2782665,S,254,269,523,3e-04
Sphingobium xenophagum,121428,S,165,350,515,3e-04
Qipengyuania flava,192812,S,201,317,518,3e-04
Roseovarius indicus,540747,S,100,422,522,3e-04
Streptomyces capitiformicae,2014920,S,204,322,526,3e-04
Micromonospora sp. WMMD987,3016089,S,164,360,524,3e-04
Micromonospora chokoriensis,356851,S,255,263,518,3e-04
Verrucomicrobium spinosum,2736,S,452,66,518,3e-04
Delftia sp. HK171,1920191,S,116,389,505,0.00029
Cupriavidus nantongensis,1796606,S,102,398,500,0.00029
Ralstonia pickettii,329,S,296,205,501,0.00029
Massilia sp. DM-R-R2A-13,2899220,S,357,149,506,0.00029
Massilia sp. R2A-15,3064278,S,265,232,497,0.00029
Massilia forsythiae,2728020,S,333,177,510,0.00029
Telluria mixta,34071,S,320,190,510,0.00029
Dechloromonas sp. TW-R-39-2,2654218,S,300,201,501,0.00029
Sulfuritalea hydrogenivorans,748811,S,424,70,494,0.00029
Pseudomonas sp. HLS-6,2049589,S,332,169,501,0.00029
Pseudomonas sp. p1(2021b),2874628,S,165,336,501,0.00029
Pseudomonas coronafaciens,53409,S,102,402,504,0.00029
Pseudomonas trivialis,200450,S,261,233,494,0.00029
Pseudomonas moraviensis,321662,S,100,402,502,0.00029
Pseudomonas kermanshahensis,2745482,S,118,389,507,0.00029
Acinetobacter sp. WCHA55,2004646,S,165,331,496,0.00029
Sphingomonas naphthae,1813468,S,205,300,505,0.00029
Novosphingobium decolorationis,2698673,S,223,275,498,0.00029
Caenibius tardaugens,169176,S,185,317,502,0.00029
Rhodobacter sp. LPB0142,1850250,S,136,358,494,0.00029
Brevundimonas sp. NIBR11,3015999,S,397,112,509,0.00029
Microbacterium arborescens,33883,S,276,232,508,0.00029
Rhodococcus sp. MTM3W5.2,1805827,S,291,212,503,0.00029
Streptomyces graminofaciens,68212,S,180,327,507,0.00029
Nocardioides anomalus,2712223,S,271,227,498,0.00029
Chryseobacterium camelliae,1265445,S,158,349,507,0.00029
Pseudomonas mosselii,78327,S,197,291,488,0.00028
Bradyrhizobium lablabi,722472,S,168,317,485,0.00028
Methylorubrum populi,223967,S,255,230,485,0.00028
Ancylobacter polymorphus,223390,S,221,271,492,0.00028
Sphingomonas sp.,28214,S,243,248,491,0.00028
Porphyrobacter sp. YT40,2547601,S,159,334,493,0.00028
Phaeobacter gallaeciensis,60890,S,116,377,493,0.00028
Caulobacter mirabilis,69666,S,351,126,477,0.00028
Mycolicibacterium madagascariense,212765,S,367,125,492,0.00028
Mycolicibacterium phocaicum,319706,S,170,313,483,0.00028
Flavobacterium sp. YJ01,3031997,S,139,339,478,0.00028
Flavobacterium sp. KACC 22763,3025668,S,118,374,492,0.00028
Flavobacterium sangjuense,2518177,S,417,75,492,0.00028
Flavobacterium aestivum,3003257,S,375,106,481,0.00028
Luteolibacter ambystomatis,2824561,S,393,91,484,0.00028
Caballeronia sp. TF1N1,2878153,S,155,321,476,0.00027
Massilia sp. LPB0304,2769491,S,304,159,463,0.00027
Massilia putida,1141883,S,270,192,462,0.00027
Janthinobacterium sp. J1-1,3065910,S,264,199,463,0.00027
Thauera sp. GDN1,2944810,S,215,257,472,0.00027
Thauera aromatica,59405,S,134,337,471,0.00027
Chromobacterium violaceum,536,S,128,342,470,0.00027
Luteimonas fraxinea,2901869,S,332,139,471,0.00027
Rhodoplanes sp. Z2-YC6860,674703,S,376,85,461,0.00027
Sphingomonas sp. NIBR02145,3014784,S,363,100,463,0.00027
Sphingomonas sp. NBWT7,2596913,S,278,188,466,0.00027
Sphingobium sp. TKS,1315974,S,132,340,472,0.00027
Cereibacter sphaeroides,1063,S,268,194,462,0.00027
Niveispirillum cyanobacteriorum,1612173,S,331,133,464,0.00027
Mycolicibacterium arabiense,1286181,S,356,117,473,0.00027
Mycolicibacterium gadium,1794,S,268,200,468,0.00027
Streptomyces sp. CdTB01,1725411,S,137,332,469,0.00027
Dactylosporangium aurantiacum,35754,S,212,249,461,0.00027
Amycolatopsis sp. WQ 127309,2932773,S,135,341,476,0.00027
Flavobacterium sp. MDT1-60,1979344,S,317,159,476,0.00027
Opitutus terrae,107709,S,407,67,474,0.00027
Polynucleobacter sp. AP-Jannik-300A-C4,2576928,S,229,224,453,0.00026
Polynucleobacter ibericus,1819725,S,361,86,447,0.00026
Burkholderia multivorans,87883,S,229,215,444,0.00026
Burkholderia cepacia,292,S,196,250,446,0.00026
Massilia sp. PAMC28688,2861283,S,347,100,447,0.00026
Massilia sp. YMA4,1593482,S,195,262,457,0.00026
Pseudoduganella flava,871742,S,295,154,449,0.00026
Herbaspirillum robiniae,2014887,S,275,178,453,0.00026
Collimonas arenae,279058,S,375,83,458,0.00026
Achromobacter denitrificans,32002,S,266,186,452,0.00026
Castellaniella defragrans,75697,S,239,204,443,0.00026
Azoarcus sp. DD4,2027405,S,243,211,454,0.00026
Pseudomonas sp. S35,1573719,S,204,240,444,0.00026
Pseudomonas cremoricolorata,157783,S,367,75,442,0.00026
Pseudomonas tohonis,2725477,S,153,305,458,0.00026
Luteibacter aegosomatis,2911537,S,252,199,451,0.00026
Brucella pseudogrignonensis,419475,S,142,313,455,0.00026
Sphingosinicella microcystinivorans,335406,S,224,232,456,0.00026
Phenylobacterium sp. LH3H17,2903901,S,353,98,451,0.00026
Brachybacterium sp. GU-2,3069708,S,102,354,456,0.00026
Mycolicibacterium chubuense,1800,S,167,290,457,0.00026
Prescottella equi,43767,S,218,231,449,0.00026
Candidatus Nanopelagicus hibericus,1884915,S,384,71,455,0.00026
Nocardioides sp. zg-1228,2763008,S,219,239,458,0.00026
Clostridium saccharoperbutylacetonicum,36745,S,287,168,455,0.00026
Mucilaginibacter sp. 21P,2778902,S,401,42,443,0.00026
Polynucleobacter sp. AM-7D1,2689102,S,212,218,430,0.00025
Pseudoduganella lutea,321985,S,244,182,426,0.00025
Pigmentiphaga sp. H8,2488560,S,361,66,427,0.00025
Azoarcus olearius,418699,S,305,131,436,0.00025
Pseudomonas sp. FP198,2954084,S,265,162,427,0.00025
Pseudomonas sp. ACM7,2052956,S,137,300,437,0.00025
Pseudomonas rhizosphaerae,216142,S,336,96,432,0.00025
Pseudomonas extremaustralis,359110,S,255,182,437,0.00025
Acinetobacter ursingii,108980,S,106,333,439,0.00025
Pantoea eucrina,472693,S,315,124,439,0.00025
Methylobacterium aquaticum,270351,S,248,180,428,0.00025
Devosia sp. SL43,2806348,S,316,120,436,0.00025
Bosea sp. REN20,3068632,S,241,187,428,0.00025
Methylocystis rosea,173366,S,198,231,429,0.00025
Novosphingobium kaempferiae,2896849,S,358,78,436,0.00025
Sphingobium sp. JS3065,2970925,S,152,286,438,0.00025
Qipengyuania spongiae,2909673,S,105,328,433,0.00025
Cellulosimicrobium cellulans,1710,S,111,330,441,0.00025
Mycolicibacterium rufum,318424,S,213,223,436,0.00025
Nocardia asteroides,1824,S,226,214,440,0.00025
Nocardioides sp. JS614,196162,S,153,275,428,0.00025
Flavobacterium faecale,1355330,S,344,85,429,0.00025
Runella rosea,2259595,S,399,31,430,0.00025
Cupriavidus cauae,2608999,S,191,233,424,0.00024
Limnobacter sp. SAORIC-580,2732163,S,395,21,416,0.00024
Janthinobacterium sp. Marseille,375286,S,283,126,409,0.00024
Collimonas fungivorans,158899,S,313,103,416,0.00024
Achromobacter mucicolens,1389922,S,185,227,412,0.00024
Methylotenera mobilis,359408,S,358,60,418,0.00024
Pseudomonas sp. 7SR1,1881017,S,273,140,413,0.00024
Pseudomonas sp. N3-W,2975049,S,261,159,420,0.00024
Pseudomonas sp. S09G 359,2054919,S,203,221,424,0.00024
Pseudomonas sp. FP453,2954094,S,183,232,415,0.00024
Pseudomonas sp.,306,S,169,239,408,0.00024
Pseudomonas sp. RtIB026,2749999,S,109,304,413,0.00024
Stenotrophomonas sp. SAU14A_NAIMI4_5,2072413,S,160,256,416,0.00024
Rheinheimera sp. MM224,3019969,S,329,86,415,0.00024
Shinella sp. HZN7,879274,S,121,290,411,0.00024
Aquibium microcysteis,675281,S,192,221,413,0.00024
Novosphingobium sp. P6W,1609758,S,338,74,412,0.00024
Altererythrobacter sp. B11,2060312,S,180,241,421,0.00024
Brevundimonas albigilva,1312364,S,183,238,421,0.00024
Brevundimonas naejangsanensis,588932,S,153,265,418,0.00024
Microbacterium sp. BH-3-3-3,1906742,S,200,208,408,0.00024
Curtobacterium sp. MCLR17_036,2175620,S,188,236,424,0.00024
Streptomyces sp. T12,477697,S,104,310,414,0.00024
Exiguobacterium acetylicum,41170,S,181,239,420,0.00024
Flavobacterium anhuiense,459526,S,200,216,416,0.00024
Mucilaginibacter daejeonensis,398049,S,387,32,419,0.00024
Luteolibacter luteus,2728835,S,379,38,417,0.00024
Candidatus Symbiobacter mobilis,1436290,S,384,15,399,0.00023
Cupriavidus sp. P-10,2027911,S,216,178,394,0.00023
Burkholderia contaminans,488447,S,149,247,396,0.00023
Pandoraea pnomenusa,93220,S,201,202,403,0.00023
Pseudoduganella armeniaca,2072590,S,161,240,401,0.00023
Collimonas pratensis,279113,S,289,101,390,0.00023
Noviherbaspirillum sp. UKPF54,2601898,S,313,86,399,0.00023
Thauera sp. K11,2005884,S,205,192,397,0.00023
Pseudomonas sp. MM227,3019968,S,297,94,391,0.00023
Pseudomonas sp. BT-42-2,2986927,S,297,105,402,0.00023
Pseudomonas sp. DR48,2871095,S,155,245,400,0.00023
Pseudomonas sp. B21-015,2895473,S,149,249,398,0.00023
Pseudomonas izuensis,2684212,S,281,113,394,0.00023
Stutzerimonas balearica,74829,S,117,275,392,0.00023
Acinetobacter cumulans,2136182,S,239,165,404,0.00023
Acinetobacter defluvii,1871111,S,187,209,396,0.00023
Stenotrophomonas rhizophila,216778,S,296,109,405,0.00023
Lysobacter capsici,435897,S,201,198,399,0.00023
Cellvibrio sp. KY-GH-1,2303332,S,241,162,403,0.00023
Legionella pneumophila,446,S,153,254,407,0.00023
Rhizobium sp. BG4,2613770,S,246,150,396,0.00023
Sinorhizobium meliloti,382,S,106,298,404,0.00023
Mesorhizobium sp. Pch-S,2082387,S,102,298,400,0.00023
Methylobacterium sp. WL1,2603276,S,295,99,394,0.00023
Xanthobacter dioxanivorans,2528964,S,169,234,403,0.00023
Porphyrobacter sp. LM 6,1896196,S,204,199,403,0.00023
Phenylobacterium parvum,2201350,S,320,79,399,0.00023
Microbacterium sp. LKL04,912630,S,203,191,394,0.00023
Microcella sp. MMS21-STM10,2963406,S,126,273,399,0.00023
Phycicoccus sp. HDW14,2714941,S,168,239,407,0.00023
Mycobacterium sp. ELW1,1547487,S,162,238,400,0.00023
Mycobacterium sp. SMC-8,2857060,S,130,273,403,0.00023
Mycobacterium grossiae,1552759,S,184,211,395,0.00023
Streptomyces formicae,1616117,S,111,290,401,0.00023
Flavobacterium sp. 140616W15,2478552,S,289,116,405,0.00023
Flavobacterium sp. CJ75,3034146,S,188,212,400,0.00023
Flavobacterium sp. B183,907046,S,130,266,396,0.00023
Flavobacterium sp. I3-2,2748319,S,106,298,404,0.00023
Flavobacterium luteolum,3003259,S,109,284,393,0.00023
Pedobacter suwonensis,332999,S,282,117,399,0.00023
Massilia sp. H6,2970464,S,275,104,379,0.00022
Janthinobacterium sp. 17J80-10,2497863,S,298,88,386,0.00022
Thiomonas arsenitoxydans,426114,S,150,235,385,0.00022
Achromobacter pestifer,1353889,S,164,214,378,0.00022
Dechloromonas sp. HYN0024,2231055,S,294,83,377,0.00022
Thauera chlorobenzoica,96773,S,160,218,378,0.00022
Pseudomonas sp. B21-040,2895486,S,217,167,384,0.00022
Pseudomonas sp. CBS,2971912,S,126,253,379,0.00022
Pseudomonas sp. NIBRBAC000502773,2590776,S,109,270,379,0.00022
Pseudomonas lundensis,86185,S,319,59,378,0.00022
Pseudomonas kielensis,2762577,S,245,135,380,0.00022
Pseudomonas antarctica,219572,S,121,255,376,0.00022
Acinetobacter soli,487316,S,220,161,381,0.00022
Xanthomonas arboricola,56448,S,144,233,377,0.00022
Rhizobium sp. WL3,2603277,S,184,194,378,0.00022
Bosea sp. ANAM02,2020412,S,213,170,383,0.00022
Sphingomonas sp. FARSPH,2219696,S,168,214,382,0.00022
Sphingomonas cannabina,2899123,S,228,151,379,0.00022
Sphingobium sp. SYK-6,627192,S,204,170,374,0.00022
Haematobacter massiliensis,195105,S,109,266,375,0.00022
Brevundimonas sp.,1871086,S,267,118,385,0.00022
Brevundimonas goettingensis,2774190,S,303,85,388,0.00022
Caulobacter sp. FWC26,69665,S,209,175,384,0.00022
Azospirillum argentinense,2970906,S,135,244,379,0.00022
Streptomyces sp. CGMCC 4.7035,3061628,S,107,269,376,0.00022
Peribacillus frigoritolerans,450367,S,176,199,375,0.00022
Flavobacterium psychrophilum,96345,S,257,122,379,0.00022
Mucilaginibacter mallensis,652787,S,346,27,373,0.00022
Sediminibacterium sp. TEGAF015,575378,S,318,63,381,0.00022
Mimasvirus GAP32,2560400,S,194,180,374,0.00022
Kinneretia sp. XES5,2877940,S,126,235,361,0.00021
Polynucleobacter sp. MWH-UH35A,1855619,S,308,53,361,0.00021
Cupriavidus sp. WKF15,3032282,S,269,100,369,0.00021
Cupriavidus sp. EM10,2839983,S,179,193,372,0.00021
Burkholderia ubonensis,101571,S,168,197,365,0.00021
Paraburkholderia fungorum,134537,S,196,160,356,0.00021
Achromobacter sp. MFA1 R4,1881016,S,182,180,362,0.00021
Pseudomonas sp. ADAK13,2730847,S,176,189,365,0.00021
Pseudomonas sp. FP2335,2954092,S,174,197,371,0.00021
Pseudomonas sp. Tri1,2823875,S,170,199,369,0.00021
Pseudomonas furukawaii,1149133,S,260,107,367,0.00021
Pseudomonas vancouverensis,95300,S,268,91,359,0.00021
Pseudomonas palleroniana,191390,S,264,102,366,0.00021
Pseudomonas silesiensis,1853130,S,246,123,369,0.00021
Pseudomonas arsenicoxydans,702115,S,219,141,360,0.00021
Acinetobacter junii,40215,S,123,235,358,0.00021
Stenotrophomonas sp. 610A2,3055080,S,118,240,358,0.00021
Kosakonia cowanii,208223,S,216,148,364,0.00021
Bradyrhizobium sediminis,2840469,S,283,83,366,0.00021
Rhodopseudomonas boonkerdii,475937,S,239,133,372,0.00021
Sphingomonas sp. J315,2898433,S,233,127,360,0.00021
Novosphingobium sp. 9,2025349,S,242,119,361,0.00021
Rhodobacter sp. CZR27,2033869,S,202,159,361,0.00021
Thioclava nitratireducens,1915078,S,106,261,367,0.00021
Brevundimonas subvibrioides,74313,S,271,95,366,0.00021
Azospirillum brasilense,192,S,152,215,367,0.00021
Cellulomonas sp. Y8,2591145,S,100,266,366,0.00021
Mycolicibacterium litorale,758802,S,198,159,357,0.00021
Streptomyces sp. Li-HN-5-11,3075432,S,112,258,370,0.00021
Streptomyces seoulensis,73044,S,118,244,362,0.00021
Flavobacterium sp. F-70,2893884,S,247,111,358,0.00021
Flavobacterium crocinum,2183896,S,173,193,366,0.00021
Flavobacterium ginsengisoli,871694,S,147,225,372,0.00021
Burkholderia pyrrocinia,60550,S,148,195,343,2e-04
Paraburkholderia aromaticivorans,2026199,S,192,159,351,2e-04
Paraburkholderia xenovorans,36873,S,127,212,339,2e-04
Massilia antarctica,2765360,S,220,123,343,2e-04
Pseudoduganella chitinolytica,34070,S,174,179,353,2e-04
Pseudoduganella umbonata,864828,S,168,172,340,2e-04
Paralcaligenes sp. CC-YST667,2979868,S,188,166,354,2e-04
Pseudomonas sp. MPC6,2498848,S,199,153,352,2e-04
Pseudomonas sp. FP597,2954096,S,174,180,354,2e-04
Pseudomonas sp. G2-4,1506334,S,159,185,344,2e-04
Pseudomonas sp. 31-12,2201356,S,153,187,340,2e-04
Pseudomonas sp. ZM23,2961893,S,146,198,344,2e-04
Pseudomonas resinovorans,53412,S,227,127,354,2e-04
Pseudomonas graminis,158627,S,204,146,350,2e-04
Acinetobacter sp. SCLZS86,2908637,S,101,247,348,2e-04
Acinetobacter seifertii,1530123,S,178,169,347,2e-04
Xanthomonas sacchari,56458,S,198,148,346,2e-04
Aeromonas salmonicida,645,S,140,215,355,2e-04
Cellvibrio sp. PSBB023,1945512,S,262,81,343,2e-04
Bosea sp. NBC_00550,2969621,S,226,124,350,2e-04
Ancylobacter sp. TS-1,1850374,S,155,198,353,2e-04
Sphingomonas paucimobilis,13689,S,150,203,353,2e-04
Sphingopyxis sp. DBS4,2968500,S,131,207,338,2e-04
Caulobacter sp. NIBR2454,3015996,S,238,104,342,2e-04
Roseomonas gilardii,257708,S,181,174,355,2e-04
Cnuibacter physcomitrellae,1619308,S,184,164,348,2e-04
Streptomyces liliifuscus,2797636,S,126,220,346,2e-04
Streptomyces asoensis,249586,S,113,226,339,2e-04
Streptomyces phaeolivaceus,2653200,S,103,245,348,2e-04
Aeromicrobium sp. Leaf245,1736306,S,142,200,342,2e-04
Metabacillus sp. cB07,2806989,S,230,112,342,2e-04
Flavobacterium sp. CLA17,2724135,S,244,98,342,2e-04
Flavobacterium sp. SLB02,2665645,S,196,146,342,2e-04
Mucilaginibacter sp. SMC90,2929803,S,287,53,340,2e-04
Mucilaginibacter celer,2305508,S,324,22,346,2e-04
Archangium violaceum,83451,S,184,155,339,2e-04
Polynucleobacter sp. VK25,1758398,S,255,71,326,0.00019
Paraburkholderia caribensis,75105,S,176,155,331,0.00019
Paraburkholderia phytofirmans,261302,S,159,162,321,0.00019
Paraburkholderia terrae,311230,S,114,214,328,0.00019
Bordetella hinzii,103855,S,200,133,333,0.00019
Pusillimonas thiosulfatoxidans,2028345,S,187,143,330,0.00019
Pigmentiphaga aceris,1940612,S,308,24,332,0.00019
Orrella dioscoreae,1851544,S,226,105,331,0.00019
Thauera sp. WB-2,2897772,S,189,137,326,0.00019
Aquaspirillum sp. LM1,1938604,S,283,44,327,0.00019
Pseudomonas sp. SO81,2983246,S,231,95,326,0.00019
Pseudomonas sp. Q1-7,3020843,S,210,112,322,0.00019
Pseudomonas sp. B21-056,2895495,S,162,159,321,0.00019
Pseudomonas sp. FP2196,2954086,S,161,166,327,0.00019
Pseudomonas sp. PP3,2815936,S,151,179,330,0.00019
Pseudomonas sp. B21-048,2895490,S,128,208,336,0.00019
Pseudomonas sp. R5-89-07,658644,S,127,206,333,0.00019
Pseudomonas mucidolens,46679,S,272,65,337,0.00019
Pseudomonas granadensis,1421430,S,135,189,324,0.00019
Pseudomonas argentinensis,289370,S,232,105,337,0.00019
Pseudomonas denitrificans (nom. rej.),43306,S,101,236,337,0.00019
Acinetobacter sp. 10FS3-1,2563897,S,144,188,332,0.00019
Acinetobacter calcoaceticus,471,S,249,73,322,0.00019
Candidatus Rickettsiella viridis,676208,S,236,100,336,0.00019
Tardiphaga sp. 37S4,1404741,S,107,228,335,0.00019
Rhizobium rhizogenes,359,S,105,229,334,0.00019
Devosia ginsengisoli,400770,S,226,106,332,0.00019
Devosia salina,2860336,S,142,190,332,0.00019
Bosea sp. F3-2,2599640,S,203,120,323,0.00019
Bosea sp. Tri-49,1867715,S,194,128,322,0.00019
Sphingomonas sp. R1,399176,S,224,111,335,0.00019
Novosphingobium humi,2282397,S,265,60,325,0.00019
Sphingobium sp. CAP-1,2676077,S,112,212,324,0.00019
Sphingopyxis sp. QXT-31,1357916,S,237,100,337,0.00019
Sphingopyxis sp. USTB-05,2830667,S,234,103,337,0.00019
Sphingopyxis fribergensis,1515612,S,176,161,337,0.00019
Erythrobacter sp. 3-20A1M,2653850,S,113,223,336,0.00019
Candidatus Aquiluna sp. UB-MaderosW2red,1855377,S,299,30,329,0.00019
Mycolicibacterium gilvum,1804,S,137,188,325,0.00019
Streptomyces aurantiacus,47760,S,136,194,330,0.00019
Streptomyces antibioticus,1890,S,101,230,331,0.00019
Streptomyces griseorubiginosus,67304,S,100,235,335,0.00019
Catellatospora sp. IY07-71,2728827,S,204,120,324,0.00019
Nocardioides sp. HDW12B,2714939,S,176,152,328,0.00019
Fictibacillus phosphorivorans,1221500,S,245,81,326,0.00019
Sphaerospermopsis torques-reginae,984207,S,256,79,335,0.00019
Flavobacterium sp. F-323,2893885,S,226,101,327,0.00019
Flavobacterium sp. KBS0721,1179672,S,182,144,326,0.00019
Flavobacterium sp. N502536,2986837,S,164,163,327,0.00019
Flavobacterium sp. GSB-24,2994319,S,145,187,332,0.00019
Flavobacterium bizetiae,2704140,S,173,153,326,0.00019
Gemmatimonas phototrophica,1379270,S,315,21,336,0.00019
Horticoccus luteus,2862869,S,296,25,321,0.00019
Polynucleobacter sp. AP-Nino-20-G2,2576917,S,247,65,312,0.00018
Herbaspirillum sp. meg3,2025949,S,270,45,315,0.00018
Herbaspirillum sp. WKF16,3028312,S,191,126,317,0.00018
Achromobacter insolitus,217204,S,228,92,320,0.00018
Azoarcus sp. DN11,356837,S,194,110,304,0.00018
Azospira inquinata,2785627,S,189,118,307,0.00018
Denitratisoma sp. DHT3,1981880,S,154,159,313,0.00018
Methyloversatilis sp. RAC08,1842540,S,278,39,317,0.00018
Sulfuriferula plumbiphila,171865,S,269,47,316,0.00018
Pseudomonas sp. J452,2898441,S,203,112,315,0.00018
Pseudomonas sp. FP2309,2954091,S,164,149,313,0.00018
Pseudomonas sp. D3,517398,S,153,155,308,0.00018
Pseudomonas sp. Seg1,2678259,S,148,171,319,0.00018
Pseudomonas sp. DTU12.3,2073078,S,139,175,314,0.00018
Pseudomonas sp. B21-053,2895493,S,133,187,320,0.00018
Pseudomonas sp. St316,2678257,S,109,210,319,0.00018
Pseudomonas viciae,2505979,S,179,134,313,0.00018
Acinetobacter sp. NCu2D-2,1608473,S,230,75,305,0.00018
Acinetobacter wanghuae,2662362,S,280,38,318,0.00018
Acinetobacter lanii,2715163,S,278,34,312,0.00018
Bradyrhizobium sp. 1(2017),1404888,S,154,163,317,0.00018
Bradyrhizobium septentrionale,1404411,S,163,154,317,0.00018
Agrobacterium vaccinii,2735528,S,253,61,314,0.00018
Neorhizobium galegae,399,S,239,79,318,0.00018
Bosea vestrisii,151416,S,177,127,304,0.00018
Sphingomonas sp. CL5.1,2653203,S,183,137,320,0.00018
Sphingomonas sp. LK11,1390395,S,143,172,315,0.00018
Sphingomonas insulae,424800,S,218,94,312,0.00018
Sphingopyxis sp. EG6,1874061,S,158,154,312,0.00018
Erythrobacter litoralis,39960,S,158,155,313,0.00018
Paracoccus zhejiangensis,1077935,S,136,181,317,0.00018
Cereibacter azotoformans,43057,S,183,123,306,0.00018
Phaeobacter inhibens,221822,S,110,206,316,0.00018
Curtobacterium sp. MCLR17_032,2175650,S,142,167,309,0.00018
Mycolicibacterium psychrotolerans,216929,S,210,106,316,0.00018
Streptomyces cynarae,2981134,S,117,191,308,0.00018
Conexibacter woesei,191495,S,183,133,316,0.00018
Flavobacterium sp. N1994,2986827,S,252,52,304,0.00018
Flavobacterium sp. N1736,2986823,S,192,118,310,0.00018
Flavobacterium crassostreae,1763534,S,224,89,313,0.00018
Flavobacterium pectinovorum,29533,S,195,118,313,0.00018
Flavobacterium humidisoli,2937442,S,144,165,309,0.00018
Mucilaginibacter sp. KACC 22773,3025671,S,284,24,308,0.00018
Mucilaginibacter mali,2740462,S,291,22,313,0.00018
Polynucleobacter sp. JS-JIR-II-b4,1758390,S,181,106,287,0.00017
Paraburkholderia sp. SUR17,3034358,S,244,54,298,0.00017
Pandoraea thiooxydans,445709,S,268,30,298,0.00017
Bordetella trematum,123899,S,189,100,289,0.00017
Pusillimonas sp. M17,2962065,S,251,45,296,0.00017
Azoarcus sp. KH32C,748247,S,247,47,294,0.00017
Azoarcus sp. CIB,198107,S,179,109,288,0.00017
Chitinimonas koreensis,356302,S,227,68,295,0.00017
Sulfuritortus calidifontis,1914471,S,171,128,299,0.00017
Pseudomonas sp. Lz4W,1206777,S,219,71,290,0.00017
Pseudomonas sp. LG1E9,2219057,S,122,173,295,0.00017
Pseudomonas sp. B21-054,2895494,S,115,179,294,0.00017
Pseudomonas tolaasii,29442,S,207,94,301,0.00017
Pseudomonas brenneri,129817,S,167,134,301,0.00017
Pseudomonas versuta,1788301,S,235,59,294,0.00017
Acinetobacter shaoyimingii,2715164,S,269,27,296,0.00017
Acinetobacter guillouiae,106649,S,127,166,293,0.00017
Devosia sp. JXJ CY 41,2917991,S,210,80,290,0.00017
Paradevosia shaoguanensis,1335043,S,165,132,297,0.00017
Labrys sp. KNU-23,2789216,S,240,47,287,0.00017
Sphingomonas sp. LM7,1938607,S,223,66,289,0.00017
Sphingomonas hengshuiensis,1609977,S,246,50,296,0.00017
Novosphingobium sp. Gsoil 351,2675225,S,263,29,292,0.00017
Sphingobium phenoxybenzoativorans,1592790,S,151,146,297,0.00017
Croceibacterium atlanticum,1267766,S,151,147,298,0.00017
Roseomonas fluvialis,1750527,S,246,45,291,0.00017
Plantibacter flavus,150123,S,130,169,299,0.00017
Mycolicibacterium sarraceniae,1534348,S,229,69,298,0.00017
Mycolicibacterium diernhoferi,1801,S,196,92,288,0.00017
Mycobacteroides abscessus,36809,S,117,178,295,0.00017
Streptomyces sp. CB01881,2078691,S,112,178,290,0.00017
Kitasatospora sp. MMS16-BH015,2018025,S,100,192,292,0.00017
Micromonospora sp. LH3U1,3018339,S,172,122,294,0.00017
Nocardioides sp. S-1144,2582905,S,154,148,302,0.00017
Nocardioides euryhalodurans,2518370,S,160,132,292,0.00017
Saccharopolyspora erythraea,1836,S,142,150,292,0.00017
Anabaena cylindrica,1165,S,170,122,292,0.00017
Flavobacterium sp. N502540,2986838,S,104,191,295,0.00017
Emticicia sp. 21SJ11W-3,2916755,S,282,12,294,0.00017
Mucilaginibacter sp. 14171R-50,2703789,S,265,25,290,0.00017
Ereboglobus luteus,1796921,S,269,25,294,0.00017
Roseimicrobium sp. ORNL1,2711231,S,290,10,300,0.00017
Polynucleobacter sp. AP-Kolm-20A-A1,2081041,S,172,99,271,0.00016
Paraburkholderia tropica,92647,S,193,81,274,0.00016
Pandoraea fibrosis,1891094,S,159,112,271,0.00016
Pandoraea apista,93218,S,142,130,272,0.00016
Pseudoduganella plicata,321984,S,173,102,275,0.00016
Herbaspirillum hiltneri,341045,S,215,61,276,0.00016
Janthinobacterium sp. 1_2014MBL_MicDiv,1644131,S,128,153,281,0.00016
Bordetella sp. N,1746199,S,233,41,274,0.00016
Bordetella genomosp. 9,1416803,S,205,72,277,0.00016
Pseudomonas sp. CC6-YY-74,1930532,S,231,42,273,0.00016
Pseudomonas sp. Leaf58,1736226,S,189,92,281,0.00016
Pseudomonas sp. MSPm1,2726956,S,161,121,282,0.00016
Pseudomonas sp. LRP2-20,2944234,S,148,125,273,0.00016
Pseudomonas sp. HN11,1344094,S,139,130,269,0.00016
Pseudomonas sp. GCEP-101,2974552,S,131,154,285,0.00016
Pseudomonas sp. B21-028,2895480,S,125,150,275,0.00016
Pseudomonas corrugata,47879,S,182,90,272,0.00016
Pseudomonas cedrina,651740,S,182,100,282,0.00016
Pseudomonas wadenswilerensis,1785161,S,160,110,270,0.00016
Pseudomonas seleniipraecipitans,640205,S,246,37,283,0.00016
Pseudomonas taetrolens,47884,S,242,42,284,0.00016
Pseudomonas psychrophila,122355,S,227,55,282,0.00016
Pseudomonas prosekii,1148509,S,202,73,275,0.00016
Pseudomonas simiae,321846,S,147,136,283,0.00016
Acinetobacter haemolyticus,29430,S,131,141,272,0.00016
Bradyrhizobium sp. CCBAU 051011,858422,S,171,98,269,0.00016
Methylobacterium tardum,374432,S,175,107,282,0.00016
Sphingomonas sp. S6-11,2991075,S,209,63,272,0.00016
Sphingomonas sp. QA11,2950605,S,105,168,273,0.00016
Sphingopyxis lindanitolerans,2054227,S,121,150,271,0.00016
uncultured Erythrobacter sp.,263913,S,208,65,273,0.00016
Altererythrobacter sp. TH136,2067415,S,176,97,273,0.00016
Croceicoccus sp. YJ47,2798724,S,114,159,273,0.00016
Paracoccus alcaliphilus,34002,S,114,155,269,0.00016
Paroceanicella profunda,2579971,S,100,171,271,0.00016
Azospirillum sp. TSH100,652764,S,169,111,280,0.00016
Microbacterium oleivorans,273677,S,173,111,284,0.00016
Herbiconiux sp. SALV-R1,2735133,S,163,110,273,0.00016
Mycolicibacterium sp. YH-1,2908837,S,210,68,278,0.00016
Mycolicibacterium smegmatis,1772,S,157,120,277,0.00016
Nocardia cyriacigeorgica,135487,S,145,127,272,0.00016
Streptomyces sp. TLI_053,1855352,S,114,162,276,0.00016
Streptomyces dengpaensis,2049881,S,110,173,283,0.00016
Micromonospora zamorensis,709883,S,154,128,282,0.00016
Actinoplanes sp. L3-i22,2836373,S,149,132,281,0.00016
Nocardioides sp. CF8,110319,S,125,147,272,0.00016
Nocardioides aquaticus,160826,S,152,130,282,0.00016
Nocardioides ungokensis,1643322,S,136,134,270,0.00016
Microlunatus sagamiharensis,546874,S,146,130,276,0.00016
Amycolatopsis sp. FDAARGOS 1241,2778070,S,127,147,274,0.00016
Bacillus pumilus,1408,S,111,168,279,0.00016
Flavobacterium sp. N2038,2986829,S,160,113,273,0.00016
Flavobacterium sp. TR2,2977321,S,128,150,278,0.00016
Mucilaginibacter xinganensis,1234841,S,265,20,285,0.00016
Sandaracinus amylolyticus,927083,S,243,39,282,0.00016
Candidatus Mycosynbacter amalyticus,2665156,S,128,143,271,0.00016
Polynucleobacter sp. JS-JIR-II-50,2576919,S,177,88,265,0.00015
Polynucleobacter sp. MWH-S4W17,1855910,S,168,87,255,0.00015
Caballeronia grimmiae,1071679,S,131,125,256,0.00015
Achromobacter sp. R39,3047478,S,199,54,253,0.00015
Bordetella genomosp. 8,1416806,S,222,40,262,0.00015
Kerstersia gyiorum,206506,S,170,93,263,0.00015
Aromatoleum petrolei,76116,S,173,93,266,0.00015
Niveibacterium microcysteis,2811415,S,222,30,252,0.00015
Oryzomicrobium terrae,1735038,S,209,59,268,0.00015
Aquitalea sp. USM4,1590041,S,118,144,262,0.00015
Vogesella sp. XCS3,2877939,S,208,58,266,0.00015
Vogesella sp. LIG4,1192162,S,199,60,259,0.00015
Paludibacterium sp. B53371,2806263,S,211,50,261,0.00015
